==========================
=======|BOXINN|===========
==========================
=====--**--------=========
=====------------=========
=====------[]----==SCORE==
=====------------==|000|==
=====----------()=========
==========================
========|LVL1|============
==========================
